0,0,0,0,0,0,0,0
0,2,0,0,0,0,0,0
0,16,13,14,0,0,0,0
0,0,0,12,0,11,0,23
0,0,0,12,0,0,0,12
0,15,13,5,13,13,13,17
0,12,0,0,0,0,0,0
0,3,0,0,0,0,0,0
#3,5,5,3
&, RANDOM ENTRANCES can be very tricky to deal with.
