0,0,0,0,0,0,0,0,0
0,0,1,0,9,0,2,0,0
0,0,12,0,0,0,12,0,0
0,0,16,13,5,13,17,0,0
0,0,0,0,12,0,0,0,0
0,0,0,0,3,0,0,0,0
0,0,0,0,0,0,0,0,0
#4,1,4,3,,,,,
&,Hello this is a note,,,,,,,
