0,0,0,0,0,0,0,0,0
0,0,1,0,2,0,0,1,0
0,0,12,0,12,0,0,12,0
0,0,16,5,20,13,9,17,0
0,0,0,12,0,0,12,0,0
0,0,0,12,0,0,12,0,0
0,0,0,4,0,0,3,0,0
0,0,0,0,0,0,0,0,0
#3,3,6,3
^,3,6,0,1,0,1,0,1
^,6,6,1,0,1,0,1,0
&,2,2,TWO EXITS! and they CAN SWITCH! Keep an eye out in the CORNER OF THE EXIT for the NEXT TYPE.
