0,0,1,0,0,1,0,0,2,0
0,0,12,0,0,12,0,0,12,0
0,0,16,9,13,20,13,11,17,0
0,0,0,12,0,0,0,12,0,0
0,0,0,16,13,5,13,17,0,0
0,0,0,0,0,12,0,0,0,0
0,0,0,0,0,12,0,0,0,0
0,0,0,0,0,4,0,0,0,0
#3,2,7,2,5,4
^,5,7,1,1,0,0,1,1,0,0
&, NAND gates output 1 if both inputs are NOT 1
