0,0,0,0,0,0,0,0,,
0,2,0,9,0,1,0,0,,
0,12,0,0,0,12,0,0,,
0,12,0,0,0,12,0,0,,
0,16,13,5,13,17,0,0,,
0,0,0,12,0,0,0,0,,
0,0,0,4,0,0,0,0,,
0,0,0,0,0,0,0,0,,
#3,4,3,1,,,,,,
^,3,6,1,1,1,1,1
&,Certain gates can be CLICKED to SWITCH. OR GATES output 1 if EITHER input is 1. WATCH OUT! ,,,,,,,,
