0,0,0,0,0,0,0,0
0,0,2,0,1,0,0,0
0,0,9,0,9,0,0,0
0,0,15,5,16,0,0,0
0,0,0,9,0,0,0,0
0,0,0,9,0,0,0,0
0,0,0,3,0,0,0,0
0,0,0,0,0,0,0,0
