2,0,1,0,2,0,1,0,1,0,2,0,2
12,0,12,0,12,0,12,0,12,0,12,0,12
16,11,17,0,16,6,17,0,16,10,17,0,12
0,12,0,0,0,12,0,0,0,12,0,0,12
15,20,13,13,10,20,13,5,13,20,5,13,19
12,0,0,0,12,0,0,12,0,0,12,0,12
12,0,0,0,12,0,0,12,0,0,16,10,17
12,0,15,13,6,13,13,20,13,14,0,12,0
21,13,7,0,0,0,0,0,0,16,13,9,0
12,0,21,13,8,13,13,18,14,0,0,16,14
12,0,12,0,0,0,0,12,16,8,0,0,3
16,13,11,14,0,0,0,4,0,16,13,14,0
0,0,0,3,0,0,0,0,0,0,0,3,0
