0,0,0,0,0,0,0,0,0
0,0,1,0,2,0,0,1,0
0,0,9,0,9,0,0,9,0
0,0,13,5,17,10,6,14,0
0,0,0,9,0,0,9,0,0
0,0,0,9,0,0,9,0,0
0,0,0,4,0,0,3,0,0
0,0,0,0,0,0,0,0,0
