0,0,0,0,0,0,0,0,0
0,0,1,0,2,0,0,1,0
0,0,12,0,12,0,0,12,0
0,0,16,9,20,13,5,17,0
0,0,0,12,0,0,12,0,0
0,0,0,12,0,0,12,0,0
0,0,0,4,0,0,3,0,0
0,0,0,0,0,0,0,0,0
