0,0,0,0,0,0,0,0
0,0,0,0,0,0,0,0
0,0,0,0,0,0,0,0
0,2,13,18,13,13,4,0
0,0,0,12,0,0,0,0
0,0,0,12,0,0,0,0
0,0,0,4,0,0,0,0
0,0,0,0,0,0,0,0
