0,0,1,0,0,0,1,0,0
0,0,12,0,0,0,12,0,0
2,18,10,0,0,0,6,18,1
0,8,16,13,6,13,17,8,0
15,19,15,14,12,15,14,21,14
12,16,17,6,20,10,16,17,12
16,13,14,12,0,12,15,13,17
0,15,17,12,0,12,16,14,0
0,16,10,20,10,20,10,17,0
0,0,12,0,12,0,12,0,0
0,0,12,0,12,0,12,0,0
0,0,4,0,4,0,3,0,0
#2,2,2,2
#6,2,6,2
#2,8,2,8
#6,8,6,8
#3,5,4,8,5,5,4,3
