2,13,18,8,18,8,14,0,0
12,0,12,0,12,0,12,0,0
21,13,6,13,10,13,5,0,0
8,0,12,0,12,0,12,0,0
21,13,10,13,11,13,9,0,0
8,0,12,0,12,0,12,0,0
21,13,11,13,9,13,5,0,0
8,0,12,0,12,0,12,0,0
16,13,5,13,6,13,11,8,3
