0,0,0,0,0,0,0,0,0,0
0,0,0,0,12,10,10,11,0,0
0,0,0,0,9,0,0,5,10,3
0,0,12,10,2,10,10,14,0,0
1,10,8,0,0,0,0,0,0,0
0,0,9,0,0,0,0,0,0,0
0,0,4,0,0,0,0,0,0,0
0,0,0,0,0,0,0,0,0,0
