0,0,0,0,0,0,0,0,0
0,0,0,0,2,0,0,0,0
0,0,0,12,17,11,0,0,0
0,0,0,9,0,9,0,0,0
0,0,0,13,5,14,0,0,0
0,0,0,0,9,0,0,0,0
0,0,0,0,4,0,0,0,0
0,0,0,0,0,0,0,0,0
