0,0,1,0,0,0,0,0,0
0,0,12,0,0,0,0,0,0
1,13,9,13,13,3,0,0,0
0,0,0,0,0,0,0,0,0
0,0,0,0,0,0,15,4,0
0,0,15,13,3,0,12,0,0
1,13,7,0,0,0,9,13,2
0,0,12,0,0,0,12,0,0
0,0,2,0,0,0,2,0,0
#6,6,2,2,2,6
