2,13,18,8,18,8,14,0,0
12,0,12,0,12,0,12,0,0
21,13,6,13,10,13,5,0,0
8,0,12,0,12,0,12,0,0
21,13,10,13,11,13,9,0,0
8,0,12,0,12,0,12,0,0
21,13,11,13,9,13,5,0,0
8,0,12,0,12,0,12,0,0
16,13,5,13,6,13,11,8,3
#2,2,4,2,4,4,2,4
#6,2,6,4,6,6,4,6,2,6
#2,8,4,8,6,8
#4,4,4,6,6,6,6,4
#7,8,5,8
