0,0,0,0,0,0,0,0
0,0,0,0,0,0,0,0
0,0,0,0,0,0,0,0
0,2,10,15,10,10,4,0
0,0,0,9,0,0,0,0
0,0,0,9,0,0,0,0
0,0,0,4,0,0,0,0
0,0,0,0,0,0,0,0
