0,0,0,0,0,0,0,0,0
0,0,0,0,2,0,0,0,0
0,0,0,15,20,14,0,0,0
0,0,0,12,0,12,0,0,0
0,0,0,16,5,17,0,0,0
0,0,0,0,12,0,0,0,0
0,0,0,0,4,0,0,0,0
0,0,0,0,0,0,0,0,0
