2,18,13,14,4,15,13,18,1
0,12,0,12,12,12,0,12,0
0,12,0,12,12,12,0,12,0
0,12,0,16,7,17,0,12,0
0,10,13,14,0,15,13,7,0
0,12,15,7,14,10,14,12,0
0,12,12,15,17,12,12,12,0
0,12,4,12,15,17,3,12,0
1,20,13,17,16,13,13,20,2
