1,14,4,14,15,14,1,0
0,21,8,22,11,16,17,0
15,17,15,17,16,13,14,0
12,0,12,0,0,0,16,4
9,13,6,13,14,0,0,0
12,0,16,14,5,13,13,3
16,18,13,17,16,14,0,0
0,21,8,18,14,12,15,4
2,17,3,17,16,20,8,0
