0,0,15,2,0,2,14,0,0
1,13,6,0,0,0,11,13,2
0,0,16,13,11,13,17,0,0
0,0,15,13,20,13,14,0,0
4,13,10,0,0,0,6,13,3
0,0,16,13,18,13,17,0,0
0,0,15,13,11,13,14,0,0
1,13,6,0,0,0,10,13,2
0,0,16,1,0,1,17,0,0
