0,0,0,0,0,0,0,0,0,0
0,0,0,0,15,13,8,14,0,0
0,0,0,0,12,0,0,9,13,3
0,0,15,13,2,13,13,17,0,0
1,13,6,0,0,0,0,0,0,0
0,0,12,0,0,0,0,0,0,0
0,0,4,0,0,0,0,0,0,0
0,0,0,0,0,0,0,0,0,0
