0,0,15,14,0,15,14,4,13,14
0,15,17,8,0,8,12,0,0,12
0,12,0,12,0,12,16,13,14,12
0,12,15,17,0,16,14,0,12,12
15,5,21,1,0,2,19,0,9,19
12,12,16,14,0,15,17,0,12,12
12,12,0,12,0,12,15,13,17,8
12,16,14,12,0,12,12,0,0,12
3,0,16,17,0,16,17,3,13,17
