2,0,1,0,2,0,1,0,1,0,2,0,2
9,0,9,0,9,0,9,0,9,0,9,0,9
13,5,14,0,13,5,14,0,13,5,14,0,9
0,9,0,0,0,9,0,0,0,9,0,0,9
12,17,10,5,10,17,10,5,10,17,5,10,16
9,0,0,9,12,5,11,9,0,0,9,0,9
9,0,0,13,14,9,13,17,11,0,13,5,14
9,0,12,10,10,5,10,10,5,11,0,9,0
18,10,5,0,0,0,0,0,0,13,10,16,0
9,0,18,10,10,10,10,15,10,11,0,13,11
9,0,9,0,0,0,0,9,0,9,0,0,3
13,10,5,11,0,0,0,4,0,13,10,11,0
0,0,0,3,0,0,0,0,0,0,0,4,0
