0,0,0,0,0,0,0,0,0,0
0,2,0,0,0,0,0,1,0,0
0,7,0,0,0,0,0,7,0,0
10,15,9,0,0,0,10,15,9,0
7,0,11,8,5,8,12,0,7,0
7,0,0,0,7,0,0,0,7,0
7,0,0,0,7,0,0,0,7,0
11,8,5,8,15,8,5,8,12,0
0,0,7,0,0,0,7,0,0,0
0,0,4,0,0,0,3,0,0,0
