0,0,1,0,0,0,0,0,0
0,0,12,0,0,0,0,0,0
1,13,5,13,13,3,0,0,0
0,0,0,0,0,0,0,0,0
0,0,0,0,0,0,15,4,0
0,0,15,13,4,0,12,0,0
1,13,11,0,0,0,5,13,2
0,0,12,0,0,0,12,0,0
0,0,2,0,0,0,2,0,0
#6,6,2,2,2,6
