3,13,14,0,15,13,14,15,2
0,0,12,0,12,0,12,12,0
0,0,12,15,10,0,21,10,0
0,0,21,6,12,0,12,12,0
15,13,10,12,16,13,17,21,1
12,0,12,12,15,13,14,12,0
12,0,12,21,6,0,21,6,0
12,0,16,17,16,13,17,12,0
4,0,0,0,0,0,0,16,2
