0,0,1,0,0,0,2,0,0
0,0,12,0,0,0,12,0,0
2,18,11,0,0,0,5,18,2
0,12,16,13,11,13,17,12,0
0,12,15,14,12,15,14,12,0
0,16,17,5,20,11,16,17,0
0,0,0,12,0,12,0,0,0
0,15,13,20,5,20,13,14,0
0,12,0,0,12,0,0,12,0
0,3,0,0,12,0,0,4,0
0,0,0,0,3,0,0,0,0
#2,2,2,2
#6,2,6,2
#3,5,4,7,5,5,4,3
