0,0,1,0,0,0,2,0,0
0,0,21,14,0,15,19,0,0
1,13,7,12,0,12,9,13,2
0,15,17,12,0,12,16,14,0
0,16,7,17,0,16,7,17,0
0,15,20,13,7,13,20,14,0
0,16,13,9,22,9,13,17,0
0,0,15,17,12,16,14,0,0
0,0,12,0,12,0,12,0,0
0,0,4,0,3,0,4,0,0
#2,2,2,2
#6,2,6,2
#4,5,4,5
#3,6,5,6,6,4,2,4
