0,0,1,0,0,0,0,0,0
0,0,12,0,0,0,0,0,0
1,13,10,13,13,3,0,0,0
0,0,0,0,0,0,0,0,0
0,0,15,13,3,0,15,3,0
1,13,6,0,0,0,12,0,0
0,0,12,0,0,0,10,13,2
0,0,2,0,0,0,12,0,0
0,0,0,0,0,0,2,0,0
#6,6,2,5,2,2,,,
^,5,2,0,1,,,,
^,7,4,1,0,,,,
^,4,4,1,1,,,,