0,1,0,1,0,2,0,2,0
0,12,0,12,0,12,0,12,0
15,20,6,17,0,16,7,20,14
12,0,12,0,0,0,12,0,12
12,0,16,13,10,13,17,0,12
16,13,14,0,12,0,15,13,17
0,0,16,6,20,7,17,0,0
0,15,13,17,0,16,13,14,0
0,3,0,0,0,0,0,4,0
