0,0,2,0,0,0,1,0
0,0,8,0,0,0,8,0
0,0,8,8,8,9,8,0
0,0,0,0,0,8,0,0
0,0,4,8,8,22,8,3
0,0,0,0,0,8,0,0
0,0,0,0,0,8,0,0
0,0,0,0,0,8,3,0
