0,0,0,0,0,0,0,0
0,0,0,2,0,1,0,0
0,0,0,12,0,12,0,0
0,0,0,16,9,17,0,0
0,0,0,0,12,0,0,0
0,0,0,0,8,0,0,0
0,0,0,0,3,0,0,0
0,0,0,0,0,0,0,0
