0,2,0,0,0,0,1,0
17,21,14,0,0,17,21,14
9,0,9,0,0,9,0,9
9,0,15,5,10,16,0,9
9,0,0,9,0,0,0,9
15,5,10,21,8,6,10,16
0,9,0,0,0,9,0,0
0,15,4,0,0,3,0,0