0,0,1,0,2,0,0,0
0,0,9,0,9,8,8,0
0,0,9,0,9,0,9,0
0,0,9,8,8,8,5,0
0,0,0,0,0,0,9,0
1,8,8,5,10,10,9,0
0,0,0,9,0,0,0,0
0,0,0,4,0,0,0,0