0,2,0,0,0,0,1,0
10,9,8,0,0,10,9,8
9,0,9,0,0,9,0,9
9,0,8,5,10,9,0,9
9,0,0,9,0,0,0,9
8,5,10,9,8,6,10,9
0,9,0,0,0,9,0,0
0,8,4,0,0,3,0,0