0,0,1,0,0,0,2,0,0
0,0,21,14,0,15,19,0,0
1,13,5,16,7,17,10,13,2
0,15,17,0,12,0,16,14,0
0,16,13,6,20,9,13,17,0
0,0,15,19,0,21,14,0,0
0,0,12,16,11,17,12,0,0
0,0,12,0,12,0,12,0,0
0,0,3,0,4,0,3,0,0
#2,2,4,2,3,4,,,
#5,4,4,2,6,2,,,
#3,4,5,4,4,6,,,
^,2,8,0,0,1,1,,
^,4,8,0,1,1,0,,
^,6,8,1,1,1,0,,