15,13,18,2,0,1,18,13,14
12,0,16,13,5,13,17,0,12
16,13,10,13,20,13,6,13,17
0,15,20,13,5,13,20,14,0
0,12,0,0,12,0,0,12,0
0,16,13,5,20,10,13,17,0
3,13,13,19,0,21,13,13,4
0,0,0,16,10,17,0,0,0
0,0,0,0,16,13,13,13,3
