0,0,0,0,0,0,0,0
0,0,1,0,0,2,0,0
0,0,12,15,13,22,14,0
0,0,16,9,0,12,12,0
0,0,0,12,0,16,5,0
0,0,0,12,0,0,12,0
0,0,0,3,0,0,3,0
0,0,0,0,0,0,0,0
