15,13,13,13,10,13,13,13,14
2,15,13,13,20,13,13,14,1
0,12,15,13,10,13,14,12,0
0,12,12,0,16,4,12,12,0
0,10,19,0,0,0,21,7,0
0,12,12,3,14,0,12,12,0
0,12,16,13,7,13,17,12,0
1,16,13,13,18,13,13,17,1
16,13,13,13,7,13,13,13,17
