3,13,9,13,18,13,13,13,4
15,13,17,15,5,13,14,0,0
16,13,14,12,0,0,10,14,0
0,15,17,5,14,0,12,16,14
15,17,0,12,16,14,12,0,12
16,14,8,17,0,12,12,15,17
15,17,12,0,15,17,12,16,14
16,14,16,13,22,13,17,15,17
1,20,13,13,9,13,13,20,2
